K 2,E  ,W  ,W  ,W  ,W  ,W  ,W  ,B 5,K 1
E  ,E  ,W  ,E  ,E  ,E  ,E  ,E  ,E  ,W  
B 4,W  ,W  ,E  ,W  ,W  ,W  ,E  ,W  ,W  
E  ,E  ,E  ,E  ,E  ,E  ,E  ,E  ,B 3,E  
W  ,W  ,W  ,W  ,W  ,W  ,B 1,W  ,W  ,K 4
E  ,E  ,E  ,E  ,E  ,E  ,E  ,E  ,E  ,W  
E  ,W  ,W  ,W  ,W  ,W  ,W  ,W  ,E  ,E  
E  ,B 2,E  ,E  ,E  ,E  ,E  ,E  ,W  ,E C
E  ,W  ,W  ,W  ,W  ,W  ,W  ,E  ,W  ,W  
E  ,E  ,E  ,K 1,E  ,K 3,W  ,K 5,B 1,F  