E  ,E  ,E  ,E  ,E  ,E  ,E  ,E  ,E  ,E  
E  ,E  ,E  ,E  ,E  ,E  ,E  ,E  ,E  ,E  
E  ,E  ,E  ,E  ,E  ,E  ,E  ,E  ,E  ,E  
E  ,E  ,E  ,E  ,E  ,E  ,E  ,E  ,E  ,E  
E  ,E  ,E  ,E  ,E  ,E  ,E  ,E  ,E  ,E  
E  ,E  ,E  ,E  ,E  ,E  ,E  ,E  ,E  ,E  
E  ,E  ,E  ,E  ,E  ,E  ,E  ,E  ,W  ,W  
E  ,E  ,E  ,E  ,E  ,E  ,E  ,E  ,W  ,E C
E  ,E  ,E  ,E  ,E  ,E  ,E  ,E  ,W  ,F  
E  ,E  ,E  ,E  ,E  ,E  ,E  ,E  ,W  ,W  