E  ,E  ,E  ,E  ,E  ,E  ,E  ,E  ,E  ,E  
W  ,W  ,B 0,W  ,W  ,W  ,W  ,E  ,E  ,E  
E  ,E  ,E  ,E  ,E  ,E  ,W  ,E  ,E  ,E  
E  ,E  ,E  ,E  ,E  ,E  ,W  ,E  ,E  ,E  
E  ,E  ,E  ,E  ,E  ,W  ,W  ,W  ,W  ,W  
E  ,E  ,E  ,E  ,E  ,W  ,W  ,E  ,E  ,E  
W  ,W  ,W  ,W  ,B 0,E  ,E  ,E  ,E  ,E  
E  ,E  ,E  ,E  ,E  ,W  ,W  ,W  ,W  ,W  
W  ,W  ,W  ,W  ,E  ,W  ,E  ,E  ,E  ,E  
W  ,W  ,W  ,W  ,E  ,B 0,E  ,E  ,E  ,F  