E  ,K 4,E  ,E  ,E  ,E  ,E  ,E  ,E  ,E  
E  ,B 4,E  ,E  ,E  ,E  ,E  ,E  ,E  ,E  
E  ,K 5,E  ,E  ,E  ,E  ,E  ,E  ,E  ,E  
E  ,B 5,E  ,E  ,E  ,E  ,E  ,E  ,E  ,E  
E  ,K 3,W  ,E  ,E  ,E  ,E  ,E  ,E  ,E  
E  ,B 4,E  ,E  ,E  ,E  ,E  ,E  ,E  ,E  
E  ,E  ,E  ,E  ,E  ,E  ,E  ,E  ,E  ,E  
E  ,E  ,E  ,E  ,E  ,E  ,E  ,W  ,E  ,E  
E  ,E  ,E  ,E  ,E  ,B 3,B 4,E C,K 4,E  
E  ,E  ,E  ,E  ,E  ,E  ,E  ,E  ,B 4,F  