E C,E  ,E  ,E  ,E  ,E  ,E  ,E  ,E  ,E  
E  ,E  ,E  ,E  ,E  ,E  ,E  ,K 0,E  ,E  
E  ,E  ,E  ,E  ,E  ,E  ,E  ,E  ,E  ,E  
E  ,E  ,E  ,E  ,E  ,E  ,E  ,E  ,E  ,E  
E  ,E  ,E  ,E  ,E  ,E  ,E  ,E  ,E  ,E  
E  ,E  ,E  ,E  ,E  ,E  ,E  ,E  ,E  ,E  
E  ,E  ,E  ,E  ,E  ,E  ,E  ,E  ,E  ,E  
E  ,E  ,E  ,E  ,E  ,E  ,E  ,E  ,B 0,B 0
E  ,E  ,E  ,E  ,E  ,E  ,E  ,E  ,B 0,F  
E  ,E  ,E  ,E  ,E  ,E  ,E  ,E  ,B 0,B 0