E C,E  ,E  ,E  ,E  ,E  ,E  ,E  ,E  ,B 16
E  ,E  ,E  ,E  ,E  ,E  ,E  ,E  ,E  ,E  
E  ,E  ,E  ,E  ,E  ,E  ,E  ,E  ,E  ,E  
E  ,E  ,E  ,E  ,F  ,E  ,E  ,E  ,E  ,E  
E  ,E  ,E  ,E  ,E  ,E  ,E  ,E  ,F  ,E  
E  ,E  ,E  ,E  ,E  ,E  ,E  ,E  ,E  ,E  
E  ,E  ,E  ,E  ,E  ,E  ,E  ,E  ,E  ,E  
E  ,E  ,E  ,E  ,E  ,E  ,E  ,E  ,E  ,E  
E  ,E  ,E  ,E  ,E  ,E  ,F  ,E  ,E  ,E  
E  ,E  ,E  ,E  ,E  ,E  ,E  ,E  ,E  ,E  