K 2,E  ,W  ,E  ,W  ,K 5,W  ,E  ,B 2,K 6
E  ,E  ,B 4,E  ,W  ,B 7,W  ,E  ,W  ,W  
W  ,W  ,W  ,E  ,E  ,E  ,E  ,E  ,W  ,W  
E  ,E  ,E  ,E  ,E  ,E  ,E  ,E  ,B 3,K 4
W  ,W  ,W  ,W  ,W  ,W  ,B 1,W  ,W  ,W  
E  ,E  ,E  ,E  ,E  ,E  ,E  ,E  ,E  ,W  
E  ,W  ,W  ,W  ,W  ,W  ,W  ,W  ,E  ,E  
E  ,B 6,E  ,E  ,E  ,K 7,B 5,F  ,W  ,E C
E  ,W  ,W  ,W  ,W  ,W  ,W  ,W  ,W  ,W  
E  ,E  ,E  ,E  ,E  ,E  ,K 1,E  ,K 3,E  